//MAP CONVERTED BY dmm2tgm.py THIS HEADER COMMENT PREVENTS RECONVERSION, DO NOT REMOVE
"a" = (
/obj/effect/turf_decal/stripes/line{
	dir = 8
	},
/obj/machinery/door/window/westright,
/turf/open/floor/wood,
/area/ruin/powered)
"b" = (
/obj/machinery/door/airlock,
/turf/open/floor/iron,
/area/ruin/powered)
"d" = (
/obj/structure/table/wood,
/obj/effect/turf_decal/stripes/line{
	dir = 10
	},
/obj/effect/spawner/random/ruinloot/basic,
/turf/open/floor/wood,
/area/ruin/powered)
"e" = (
/obj/structure/table/wood,
/obj/effect/turf_decal/stripes/line,
/obj/item/food/pie/cream,
/turf/open/floor/wood,
/area/ruin/powered)
"h" = (
/obj/structure/chair{
	dir = 4
	},
/obj/effect/turf_decal/tile/bar/opposingcorners,
/turf/open/floor/iron,
/area/ruin/powered)
"i" = (
/obj/structure/flora/junglebush/c,
/turf/open/floor/grass,
/area/ruin/powered)
"k" = (
/obj/structure/flora/grass/jungle,
/turf/open/floor/grass,
/area/ruin/powered)
"l" = (
/obj/machinery/door/firedoor,
/obj/machinery/door/airlock/public/glass,
/turf/open/floor/iron,
/area/ruin/powered)
"m" = (
/turf/open/floor/wood,
/area/ruin/powered)
"o" = (
/obj/structure/mirror{
	pixel_x = 32
	},
/obj/effect/turf_decal/tile/blue/opposingcorners{
	dir = 1
	},
/obj/effect/turf_decal/tile/red/opposingcorners,
/turf/open/floor/iron,
/area/ruin/powered)
"p" = (
/obj/effect/spawner/structure/window/shutter,
/turf/open/floor/plating,
/area/ruin/powered)
"q" = (
/obj/structure/flora/grass/jungle/b,
/obj/structure/flora/ausbushes/ppflowers,
/obj/structure/window/spawner/directional/south,
/turf/open/floor/grass,
/area/ruin/powered)
"r" = (
/obj/structure/chair{
	dir = 8
	},
/obj/effect/turf_decal/tile/bar/opposingcorners,
/turf/open/floor/iron,
/area/ruin/powered)
"s" = (
/obj/effect/abstract/doorway_marker{
	dir = 8
	},
/turf/open/floor/iron,
/area/ruin/powered)
"t" = (
/obj/structure/table/wood,
/obj/effect/turf_decal/stripes/line,
/turf/open/floor/wood,
/area/ruin/powered)
"u" = (
/turf/closed/wall,
/area/ruin/powered)
"v" = (
/obj/structure/sign/plaques/deempisi{
	pixel_x = -28;
	pixel_y = -4
	},
/turf/open/floor/wood,
/area/ruin/powered)
"w" = (
/turf/open/floor/iron/white/side{
	dir = 4
	},
/area/ruin/powered)
"x" = (
/obj/structure/table,
/obj/effect/turf_decal/tile/bar/opposingcorners,
/turf/open/floor/iron,
/area/ruin/powered)
"y" = (
/obj/effect/abstract/doorway_marker,
/turf/open/floor/iron,
/area/ruin/powered)
"z" = (
/obj/effect/turf_decal/tile/bar/opposingcorners,
/turf/open/floor/iron,
/area/ruin/powered)
"A" = (
/obj/structure/table/wood,
/obj/machinery/chem_dispenser/drinks/beer,
/turf/open/floor/wood,
/area/ruin/powered)
"B" = (
/obj/effect/abstract/open_area_marker{
	dir = 4
	},
/turf/open/floor/iron,
/area/ruin/powered)
"C" = (
/obj/structure/flora/junglebush/large,
/turf/open/floor/grass,
/area/ruin/powered)
"D" = (
/obj/structure/closet/crate/wooden/toy,
/obj/effect/spawner/random/ruinloot/security,
/obj/effect/turf_decal/tile/blue/opposingcorners{
	dir = 1
	},
/obj/effect/turf_decal/tile/red/opposingcorners,
/turf/open/floor/iron,
/area/ruin/powered)
"E" = (
/obj/structure/dresser,
/turf/open/floor/iron/white/side{
	dir = 4
	},
/area/ruin/powered)
"F" = (
/obj/structure/table/wood,
/obj/item/book/manual/wiki/barman_recipes{
	pixel_y = 6
	},
/obj/item/reagent_containers/cup/glass/shaker{
	pixel_x = 6;
	pixel_y = 2
	},
/obj/item/reagent_containers/cup/rag{
	pixel_x = -3;
	pixel_y = 2
	},
/turf/open/floor/wood,
/area/ruin/powered)
"H" = (
/obj/structure/flora/ausbushes/brflowers,
/obj/structure/window/spawner/directional/south,
/turf/open/floor/grass,
/area/ruin/powered)
"I" = (
/obj/structure/table/wood,
/turf/open/floor/iron/white/side{
	dir = 4
	},
/area/ruin/powered)
"J" = (
/obj/machinery/vending/autodrobe,
/turf/open/floor/iron/white/side{
	dir = 4
	},
/area/ruin/powered)
"M" = (
/obj/effect/abstract/open_area_marker{
	dir = 8
	},
/turf/open/floor/iron,
/area/ruin/powered)
"N" = (
/obj/machinery/vending/boozeomat/all_access,
/turf/open/floor/wood,
/area/ruin/powered)
"O" = (
/obj/structure/table/wood,
/obj/machinery/chem_dispenser/drinks,
/turf/open/floor/wood,
/area/ruin/powered)
"P" = (
/obj/structure/chair/stool/bar,
/obj/effect/turf_decal/tile/bar/opposingcorners,
/turf/open/floor/iron,
/area/ruin/powered)
"Q" = (
/obj/effect/turf_decal/tile/blue/opposingcorners{
	dir = 1
	},
/obj/effect/turf_decal/tile/red/opposingcorners,
/turf/open/floor/iron,
/area/ruin/powered)
"R" = (
/obj/effect/abstract/doorway_marker{
	dir = 4
	},
/turf/open/floor/iron,
/area/ruin/powered)
"S" = (
/obj/structure/table/wood,
/obj/effect/turf_decal/stripes/line{
	dir = 8
	},
/turf/open/floor/wood,
/area/ruin/powered)
"V" = (
/obj/structure/flora/junglebush/b,
/obj/structure/window/spawner/directional/south,
/turf/open/floor/grass,
/area/ruin/powered)
"W" = (
/obj/effect/abstract/open_area_marker,
/turf/open/floor/iron,
/area/ruin/powered)
"Y" = (
/turf/open/floor/iron,
/area/ruin/powered)
"Z" = (
/obj/structure/table/wood,
/obj/effect/turf_decal/tile/blue/opposingcorners{
	dir = 1
	},
/obj/effect/turf_decal/tile/red/opposingcorners,
/turf/open/floor/iron,
/area/ruin/powered)

(1,1,1) = {"
u
u
u
u
u
u
s
u
u
Y
M
Y
u
"}
(2,1,1) = {"
u
E
I
Z
D
u
z
h
p
Y
Y
Y
u
"}
(3,1,1) = {"
u
w
w
Q
Q
u
z
x
p
Y
Y
Y
y
"}
(4,1,1) = {"
u
J
w
o
Q
u
z
r
p
Y
Y
Y
u
"}
(5,1,1) = {"
u
u
u
u
b
u
z
z
u
Y
Y
Y
u
"}
(6,1,1) = {"
u
k
H
z
z
z
z
z
l
Y
Y
Y
Y
"}
(7,1,1) = {"
u
C
V
z
z
z
z
z
p
Y
Y
Y
W
"}
(8,1,1) = {"
u
i
q
z
P
P
z
z
l
Y
Y
Y
Y
"}
(9,1,1) = {"
u
u
u
a
S
d
P
z
u
Y
Y
Y
u
"}
(10,1,1) = {"
u
O
v
m
m
t
P
z
p
Y
Y
Y
u
"}
(11,1,1) = {"
u
A
m
m
m
t
P
z
p
Y
Y
Y
y
"}
(12,1,1) = {"
u
N
F
m
m
e
z
z
p
Y
Y
Y
u
"}
(13,1,1) = {"
u
u
u
u
u
u
R
u
u
Y
B
Y
u
"}
