//MAP CONVERTED BY dmm2tgm.py THIS HEADER COMMENT PREVENTS RECONVERSION, DO NOT REMOVE
"cp" = (
/obj/item/gun/energy/recharge/kinetic_accelerator,
/obj/structure/rack,
/obj/effect/turf_decal/tile/purple,
/turf/open/floor/iron/white,
/area/ruin/powered)
"ec" = (
/turf/open/floor/iron/dark,
/area/ruin/powered)
"ed" = (
/obj/effect/turf_decal/stripes/line{
	dir = 1
	},
/turf/open/floor/iron/freezer,
/area/ruin/powered)
"ek" = (
/obj/machinery/door/airlock/research{
	name = "Robotics"
	},
/turf/open/floor/iron/white,
/area/ruin/powered)
"eq" = (
/obj/machinery/door/firedoor,
/obj/structure/table/reinforced,
/obj/machinery/door/window/northleft,
/turf/open/floor/plating,
/area/ruin/powered)
"gb" = (
/obj/structure/showcase/mecha/marauder,
/obj/structure/window/spawner/directional/south,
/turf/open/floor/wood,
/area/ruin/powered)
"gr" = (
/turf/open/floor/iron/dark/side{
	dir = 8
	},
/area/ruin/powered)
"gt" = (
/obj/structure/table,
/obj/item/storage/backpack/duffelbag/med/surgery,
/obj/effect/turf_decal/tile/blue/half/contrasted{
	dir = 4
	},
/turf/open/floor/iron/white,
/area/ruin/powered)
"gI" = (
/obj/effect/abstract/open_area_marker{
	dir = 4
	},
/turf/open/floor/iron/airless,
/area/ruin/powered)
"gJ" = (
/obj/effect/spawner/structure/window/reinforced/tinted,
/turf/open/floor/plating,
/area/ruin/powered)
"gX" = (
/obj/effect/turf_decal/stripes/line,
/obj/machinery/rnd/destructive_analyzer,
/turf/open/floor/iron/freezer,
/area/ruin/powered)
"hf" = (
/obj/structure/bed/roller,
/obj/machinery/iv_drip,
/obj/effect/turf_decal/tile/blue/half/contrasted{
	dir = 8
	},
/turf/open/floor/iron/white,
/area/ruin/powered)
"hJ" = (
/turf/open/floor/iron/dark/side{
	dir = 10
	},
/area/ruin/powered)
"il" = (
/obj/structure/sign/departments/minsky/research/research{
	pixel_y = 32
	},
/turf/open/floor/iron,
/area/ruin/powered)
"iY" = (
/obj/effect/turf_decal/tile/purple/anticorner/contrasted,
/turf/open/floor/iron/white,
/area/ruin/powered)
"jP" = (
/obj/machinery/smartfridge/organ,
/obj/effect/turf_decal/tile/blue/anticorner/contrasted{
	dir = 8
	},
/turf/open/floor/iron/white,
/area/ruin/powered)
"kf" = (
/obj/machinery/door/airlock/research/glass{
	name = "Research Division"
	},
/turf/open/floor/iron/white/side{
	dir = 1
	},
/area/ruin/powered)
"ko" = (
/obj/effect/spawner/random/decoration/glowstick/lit,
/obj/structure/sign/departments/minsky/research/robotics{
	pixel_y = 32
	},
/turf/open/floor/iron/airless,
/area/ruin/powered)
"kF" = (
/obj/effect/abstract/open_area_marker{
	dir = 8
	},
/turf/open/floor/iron,
/area/ruin/powered)
"kM" = (
/obj/effect/turf_decal/stripes/line,
/turf/open/floor/iron/freezer,
/area/ruin/powered)
"ln" = (
/obj/machinery/cryopod,
/turf/open/floor/iron/showroomfloor,
/area/ruin/powered)
"nL" = (
/obj/effect/turf_decal/tile/blue{
	dir = 1
	},
/turf/open/floor/iron/white,
/area/ruin/powered)
"nR" = (
/obj/machinery/suit_storage_unit{
	suit_type = /obj/item/clothing/suit/space/hardsuit/ancient
	},
/obj/effect/turf_decal/tile/purple{
	dir = 4
	},
/turf/open/floor/iron/white,
/area/ruin/powered)
"oq" = (
/obj/structure/closet/crate,
/obj/item/storage/backpack/old,
/obj/item/storage/backpack/old,
/obj/item/crowbar,
/obj/effect/spawner/random/ruinloot/science,
/turf/open/floor/iron/white,
/area/ruin/powered)
"pH" = (
/obj/machinery/modular_fabricator/exosuit_fab,
/obj/effect/turf_decal/tile/purple/anticorner/contrasted{
	dir = 4
	},
/turf/open/floor/iron/white,
/area/ruin/powered)
"qy" = (
/obj/machinery/door/firedoor,
/obj/structure/table/reinforced,
/obj/machinery/door/window/westleft,
/turf/open/floor/plating,
/area/ruin/powered)
"qV" = (
/turf/open/floor/iron/airless,
/area/ruin/powered)
"rM" = (
/obj/structure/table/glass/plasma,
/obj/item/storage/box/firingpins{
	pixel_y = 9
	},
/obj/item/stack/sheet/mineral/silver/five,
/obj/item/stack/sheet/mineral/gold/five{
	pixel_x = 7;
	pixel_y = -2
	},
/obj/item/reagent_containers/cup/soda_cans/cola{
	pixel_x = -7
	},
/turf/open/floor/iron/white,
/area/ruin/powered)
"rW" = (
/obj/item/stock_parts/scanning_module{
	pixel_x = 2;
	pixel_y = 3
	},
/obj/item/stock_parts/manipulator,
/obj/machinery/recharger,
/obj/structure/table/glass/plasma,
/obj/effect/turf_decal/tile/purple{
	dir = 4
	},
/turf/open/floor/iron/white,
/area/ruin/powered)
"sf" = (
/obj/item/stock_parts/matter_bin{
	pixel_y = 4
	},
/obj/item/stock_parts/capacitor{
	pixel_y = 6
	},
/obj/item/storage/toolbox/mechanical,
/obj/item/multitool,
/obj/structure/table/glass/plasma,
/obj/effect/turf_decal/tile/purple{
	dir = 4
	},
/turf/open/floor/iron/white,
/area/ruin/powered)
"si" = (
/obj/effect/turf_decal/tile/purple,
/turf/open/floor/iron,
/area/ruin/powered)
"tn" = (
/obj/machinery/the_singularitygen,
/turf/open/floor/iron/dark,
/area/ruin/powered)
"uN" = (
/obj/structure/sign/departments/minsky/medical/chemistry/chemical2{
	pixel_x = -32
	},
/turf/open/floor/iron,
/area/ruin/powered)
"vf" = (
/obj/item/flashlight/glowstick,
/obj/item/flashlight/glowstick,
/obj/item/shuttle_creator,
/obj/structure/closet/crate/engineering,
/obj/item/storage/toolbox/syndicate,
/turf/open/floor/iron/white,
/area/ruin/powered)
"vB" = (
/obj/item/healthanalyzer{
	desc = "A prototype hand-held body scanner able to distinguish vital signs of the subject.";
	name = "prototype health analyzer"
	},
/obj/structure/rack,
/obj/structure/window/spawner/directional/north,
/turf/open/floor/wood,
/area/ruin/powered)
"wd" = (
/obj/structure/showcase/mecha/ripley,
/obj/structure/window/spawner/directional/south,
/turf/open/floor/wood,
/area/ruin/powered)
"wq" = (
/obj/effect/decal/cleanable/blood,
/obj/effect/decal/cleanable/dirt,
/obj/machinery/computer/cryopod{
	pixel_y = 28
	},
/turf/open/floor/iron/showroomfloor,
/area/ruin/powered)
"wG" = (
/obj/machinery/door/airlock/medical/glass{
	name = "Chemistry"
	},
/turf/open/floor/iron/white/side{
	dir = 8
	},
/area/ruin/powered)
"xO" = (
/obj/structure/rack,
/obj/item/storage/firstaid/regular,
/turf/open/floor/iron/white,
/area/ruin/powered)
"xX" = (
/obj/structure/sign/departments/minsky/medical/medical2{
	pixel_y = -32
	},
/turf/open/floor/iron,
/area/ruin/powered)
"ym" = (
/obj/structure/showcase/machinery/tv,
/obj/structure/table/wood,
/obj/structure/window/spawner/directional/south,
/turf/open/floor/wood,
/area/ruin/powered)
"yA" = (
/obj/effect/mob_spawn/human/oldsec{
	dir = 4
	},
/turf/open/floor/iron/showroomfloor,
/area/ruin/powered)
"yX" = (
/turf/open/floor/iron/dark/side{
	dir = 9
	},
/area/ruin/powered)
"zs" = (
/obj/structure/rack,
/obj/item/gun/energy/e_gun/old,
/obj/structure/window/spawner/directional/north,
/turf/open/floor/wood,
/area/ruin/powered)
"AS" = (
/obj/item/stack/cable_coil,
/obj/item/stock_parts/micro_laser,
/obj/item/circuitboard/machine/ore_silo,
/obj/structure/table/glass/plasma,
/obj/effect/turf_decal/tile/purple{
	dir = 4
	},
/turf/open/floor/iron/white,
/area/ruin/powered)
"Bj" = (
/obj/effect/turf_decal/tile/purple,
/turf/open/floor/iron/white,
/area/ruin/powered)
"Cg" = (
/obj/effect/turf_decal/stripes/line{
	dir = 9
	},
/obj/machinery/rnd/production/protolathe,
/turf/open/floor/iron/freezer,
/area/ruin/powered)
"CA" = (
/obj/effect/spawner/structure/window/reinforced,
/turf/open/floor/plating,
/area/ruin/powered)
"CQ" = (
/obj/structure/chair/office/light,
/turf/open/floor/iron/white,
/area/ruin/powered)
"Dr" = (
/obj/machinery/chem_heater,
/turf/open/floor/iron/white,
/area/ruin/powered)
"DE" = (
/obj/machinery/door/firedoor,
/obj/machinery/smartfridge/chemistry/preloaded,
/turf/open/floor/plating,
/area/ruin/powered)
"DX" = (
/obj/structure/showcase/machinery/microwave,
/obj/structure/table/wood,
/obj/structure/window/spawner/directional/south,
/turf/open/floor/wood,
/area/ruin/powered)
"En" = (
/obj/effect/spawner/random/ruinloot/basic,
/turf/open/floor/iron,
/area/ruin/powered)
"Ev" = (
/obj/effect/turf_decal/tile/purple{
	dir = 4
	},
/turf/open/floor/iron,
/area/ruin/powered)
"Ew" = (
/obj/effect/turf_decal/tile/purple{
	dir = 1
	},
/turf/open/floor/iron/white,
/area/ruin/powered)
"ER" = (
/obj/machinery/computer/rdconsole/unlocked{
	dir = 8
	},
/obj/effect/turf_decal/stripes/line{
	dir = 1
	},
/turf/open/floor/iron/freezer,
/area/ruin/powered)
"Fl" = (
/obj/structure/chair/office/light,
/obj/effect/turf_decal/tile/purple/anticorner/contrasted{
	dir = 8
	},
/turf/open/floor/iron/white,
/area/ruin/powered)
"Fy" = (
/obj/effect/turf_decal/tile/blue{
	dir = 8
	},
/turf/open/floor/iron,
/area/ruin/powered)
"IJ" = (
/obj/effect/decal/cleanable/dirt,
/obj/effect/mob_spawn/human/oldeng{
	dir = 4
	},
/turf/open/floor/iron/showroomfloor,
/area/ruin/powered)
"Jf" = (
/obj/effect/spawner/random/decoration/glowstick/lit,
/turf/open/floor/iron,
/area/ruin/powered)
"Jh" = (
/obj/machinery/door/airlock/research/glass{
	name = "Research Division"
	},
/turf/open/floor/iron/white/side{
	dir = 4
	},
/area/ruin/powered)
"Jx" = (
/obj/structure/rack,
/obj/item/stack/sheet/iron/fifty,
/obj/item/stack/sheet/glass/fifty,
/obj/item/stack/sheet/mineral/copper/five,
/obj/item/stack/sheet/mineral/plasma/five,
/obj/effect/turf_decal/tile/purple/anticorner/contrasted{
	dir = 1
	},
/turf/open/floor/iron/white,
/area/ruin/powered)
"JM" = (
/obj/effect/mob_spawn/human/oldsci{
	dir = 8
	},
/turf/open/floor/iron/showroomfloor,
/area/ruin/powered)
"JN" = (
/obj/machinery/door/airlock/medical{
	name = "Surgical Theatre"
	},
/turf/open/floor/iron/white,
/area/ruin/powered)
"JO" = (
/obj/structure/rack,
/obj/item/clothing/suit/armor/vest/old{
	pixel_x = -1;
	pixel_y = 4
	},
/obj/item/clothing/head/helmet/old{
	pixel_x = 2;
	pixel_y = -2
	},
/obj/structure/window/spawner/directional/north,
/turf/open/floor/wood,
/area/ruin/powered)
"LC" = (
/obj/machinery/door/airlock/medical{
	name = "Medical"
	},
/turf/open/floor/iron/white/side,
/area/ruin/powered)
"MK" = (
/obj/structure/frame/machine,
/obj/item/stack/cable_coil,
/turf/open/floor/iron/white,
/area/ruin/powered)
"MN" = (
/turf/open/floor/iron,
/area/ruin/powered)
"Nl" = (
/turf/closed/wall,
/area/ruin/powered)
"Nq" = (
/obj/machinery/stasis,
/obj/effect/turf_decal/tile/blue/half/contrasted{
	dir = 4
	},
/turf/open/floor/iron/white,
/area/ruin/powered)
"Ns" = (
/obj/machinery/door/airlock/public/glass{
	name = "Cryogenics"
	},
/obj/effect/turf_decal/stripes/line,
/turf/open/floor/iron/showroomfloor,
/area/ruin/powered)
"Nu" = (
/turf/open/floor/iron/white/side{
	dir = 4
	},
/area/ruin/powered)
"Pb" = (
/obj/machinery/rnd/production/circuit_imprinter,
/obj/effect/turf_decal/stripes/line{
	dir = 10
	},
/turf/open/floor/iron/freezer,
/area/ruin/powered)
"Pt" = (
/obj/effect/decal/cleanable/dirt,
/obj/item/gun/energy/laser/retro/old{
	pixel_x = 2;
	pixel_y = 2
	},
/obj/item/gun/energy/laser/retro/old{
	pixel_x = -2;
	pixel_y = -2
	},
/turf/open/floor/iron/showroomfloor,
/area/ruin/powered)
"Pw" = (
/obj/structure/lattice,
/turf/template_noop,
/area/template_noop)
"QB" = (
/turf/template_noop,
/area/template_noop)
"QY" = (
/obj/machinery/chem_master,
/obj/effect/turf_decal/tile/blue/half/contrasted{
	dir = 8
	},
/turf/open/floor/iron/white,
/area/ruin/powered)
"RW" = (
/obj/structure/table/optable,
/obj/machinery/defibrillator_mount/loaded{
	pixel_x = -28
	},
/obj/effect/turf_decal/tile/blue/half/contrasted{
	dir = 1
	},
/turf/open/floor/iron/white,
/area/ruin/powered)
"SC" = (
/obj/machinery/computer/operating{
	dir = 4
	},
/obj/effect/turf_decal/tile/blue/anticorner/contrasted{
	dir = 1
	},
/turf/open/floor/iron/white,
/area/ruin/powered)
"SY" = (
/obj/effect/turf_decal/tile/blue,
/turf/open/floor/iron,
/area/ruin/powered)
"UM" = (
/obj/item/reagent_containers/cup/beaker,
/obj/structure/table,
/obj/effect/turf_decal/tile/blue/half/contrasted{
	dir = 8
	},
/turf/open/floor/iron/white,
/area/ruin/powered)
"Vo" = (
/obj/machinery/door/airlock/command/glass{
	name = "Corporate Showroom"
	},
/turf/open/floor/iron,
/area/ruin/powered)
"Vs" = (
/obj/effect/spawner/random/decoration/glowstick/lit,
/turf/open/floor/iron/white,
/area/ruin/powered)
"VQ" = (
/obj/structure/table,
/obj/item/tank/internals/anesthetic,
/obj/item/clothing/mask/breath/medical,
/obj/effect/turf_decal/tile/blue/half/contrasted{
	dir = 8
	},
/turf/open/floor/iron/white,
/area/ruin/powered)
"VV" = (
/obj/structure/table/glass/plasma,
/obj/item/stack/sheet/mineral/diamond/five{
	pixel_y = 4
	},
/obj/item/stack/sheet/mineral/uranium/twenty,
/turf/open/floor/iron/white,
/area/ruin/powered)
"We" = (
/obj/machinery/modular_fabricator/autolathe/hacked,
/obj/machinery/door/firedoor,
/obj/machinery/door/window/northright,
/turf/open/floor/plating,
/area/ruin/powered)
"Wm" = (
/turf/open/floor/iron/white,
/area/ruin/powered)
"WE" = (
/obj/machinery/anesthetic_machine,
/obj/effect/turf_decal/tile/blue/half/contrasted{
	dir = 8
	},
/turf/open/floor/iron/white,
/area/ruin/powered)
"YB" = (
/obj/machinery/shower{
	dir = 4
	},
/turf/open/floor/noslip/white,
/area/ruin/powered)
"YH" = (
/turf/open/floor/iron/white/side{
	dir = 6
	},
/area/ruin/powered)
"YU" = (
/obj/effect/turf_decal/bot_white,
/turf/open/floor/iron/white,
/area/ruin/powered)
"Zg" = (
/obj/item/clothing/gloves/color/fyellow/old,
/obj/structure/rack,
/obj/structure/window/spawner/directional/north,
/turf/open/floor/wood,
/area/ruin/powered)
"ZX" = (
/turf/open/floor/iron/white/side{
	dir = 5
	},
/area/ruin/powered)

(1,1,1) = {"
QB
Pw
QB
QB
QB
Nl
Nl
Nl
Nl
MN
kF
MN
Nl
Nl
Nl
Nl
Nl
"}
(2,1,1) = {"
QB
Pw
Pw
Pw
Pw
Nl
yA
IJ
Nl
MN
MN
MN
Nl
SC
RW
jP
Nl
"}
(3,1,1) = {"
QB
Pw
QB
QB
QB
Nl
wq
Pt
Ns
Jf
MN
MN
gJ
gt
Wm
VQ
Nl
"}
(4,1,1) = {"
QB
Pw
QB
QB
QB
Nl
ln
JM
Nl
MN
MN
SY
Nl
Nq
Wm
WE
Nl
"}
(5,1,1) = {"
Pw
Nl
Nl
Nl
CA
Nl
Nl
Nl
Nl
MN
MN
Nl
Nl
Nl
JN
Nl
Nl
"}
(6,1,1) = {"
QB
Nl
wd
ec
tn
ec
zs
Nl
MN
MN
xX
Nl
nL
Wm
Wm
hf
Nl
"}
(7,1,1) = {"
QB
Nl
ym
ec
ec
ec
JO
CA
MN
MN
MN
LC
Wm
Dr
Wm
QY
Nl
"}
(8,1,1) = {"
QB
Nl
DX
ec
ec
ec
Zg
Nl
Ev
MN
si
Nl
Wm
MK
CQ
UM
Nl
"}
(9,1,1) = {"
QB
Nl
gb
yX
gr
hJ
vB
Nl
Nl
Jh
Nl
Nl
wG
Nl
qy
DE
Nl
"}
(10,1,1) = {"
Pw
Nl
Nl
Nl
Vo
Nl
Nl
Nl
Ew
Wm
YB
Nl
il
uN
MN
Fy
Nl
"}
(11,1,1) = {"
QB
Nl
rM
ZX
Nu
YH
Wm
Wm
Wm
Wm
Wm
kf
MN
MN
En
MN
Nl
"}
(12,1,1) = {"
QB
Nl
VV
Wm
Wm
Vs
Wm
Wm
Wm
Wm
Wm
Nl
Ev
MN
qV
qV
Nl
"}
(13,1,1) = {"
QB
Nl
nR
Wm
Wm
oq
vf
Bj
Nl
Nl
ek
Nl
Nl
ko
qV
qV
Nl
"}
(14,1,1) = {"
Pw
Nl
Nl
sf
Wm
Cg
Pb
Bj
Nl
Jx
Wm
Fl
eq
qV
qV
qV
Nl
"}
(15,1,1) = {"
Pw
Pw
Nl
AS
Wm
ed
kM
Bj
Nl
xO
Wm
Wm
CA
qV
qV
qV
Nl
"}
(16,1,1) = {"
QB
Pw
Nl
rW
Wm
ER
gX
cp
Nl
pH
YU
iY
We
qV
qV
qV
Nl
"}
(17,1,1) = {"
QB
QB
Nl
Nl
Nl
Nl
Nl
Nl
Nl
Nl
Nl
Nl
Nl
qV
gI
qV
Nl
"}
