//MAP CONVERTED BY dmm2tgm.py THIS HEADER COMMENT PREVENTS RECONVERSION, DO NOT REMOVE
"a" = (
/obj/effect/turf_decal/stripes/corner{
	dir = 8
	},
/turf/open/floor/iron,
/area/ruin/powered)
"d" = (
/obj/machinery/portable_atmospherics/scrubber/huge,
/obj/effect/turf_decal/bot,
/turf/open/floor/iron,
/area/ruin/powered)
"e" = (
/obj/machinery/portable_atmospherics/canister/oxygen,
/obj/effect/decal/cleanable/dirt,
/obj/effect/turf_decal/bot,
/obj/machinery/light,
/turf/open/floor/iron,
/area/ruin/powered)
"i" = (
/obj/effect/abstract/doorway_marker{
	dir = 1
	},
/turf/open/floor/iron,
/area/ruin/powered)
"k" = (
/obj/effect/turf_decal/stripes/line,
/turf/open/floor/iron,
/area/ruin/powered)
"l" = (
/obj/machinery/portable_atmospherics/canister/nitrous_oxide,
/obj/effect/decal/cleanable/dirt,
/obj/effect/turf_decal/bot,
/turf/open/floor/iron,
/area/ruin/powered)
"p" = (
/obj/machinery/portable_atmospherics/canister/oxygen,
/obj/effect/decal/cleanable/dirt,
/obj/effect/turf_decal/bot,
/turf/open/floor/iron,
/area/ruin/powered)
"q" = (
/obj/machinery/portable_atmospherics/scrubber/huge,
/obj/effect/decal/cleanable/dirt,
/obj/effect/turf_decal/bot,
/turf/open/floor/iron,
/area/ruin/powered)
"r" = (
/obj/effect/turf_decal/stripes/line{
	dir = 4
	},
/turf/open/floor/iron,
/area/ruin/powered)
"t" = (
/obj/effect/decal/cleanable/dirt,
/obj/effect/turf_decal/delivery,
/turf/open/floor/iron,
/area/ruin/powered)
"v" = (
/obj/effect/turf_decal/bot,
/obj/machinery/portable_atmospherics/pump,
/turf/open/floor/iron,
/area/ruin/powered)
"z" = (
/obj/machinery/portable_atmospherics/canister/oxygen,
/obj/effect/turf_decal/bot,
/turf/open/floor/iron,
/area/ruin/powered)
"C" = (
/obj/machinery/portable_atmospherics/canister/plasma,
/obj/effect/turf_decal/bot,
/turf/open/floor/iron,
/area/ruin/powered)
"D" = (
/obj/effect/turf_decal/stripes/corner,
/turf/open/floor/iron,
/area/ruin/powered)
"F" = (
/obj/machinery/portable_atmospherics/canister/nitrous_oxide,
/obj/effect/turf_decal/bot,
/turf/open/floor/iron,
/area/ruin/powered)
"I" = (
/obj/effect/turf_decal/delivery,
/turf/open/floor/iron,
/area/ruin/powered)
"K" = (
/obj/machinery/portable_atmospherics/canister/plasma,
/obj/effect/turf_decal/bot,
/obj/machinery/light,
/turf/open/floor/iron,
/area/ruin/powered)
"N" = (
/obj/effect/turf_decal/bot,
/obj/machinery/portable_atmospherics/pump{
	name = "Lil Pump"
	},
/turf/open/floor/iron,
/area/ruin/powered)
"O" = (
/obj/effect/turf_decal/stripes/line{
	dir = 8
	},
/turf/open/floor/iron,
/area/ruin/powered)
"Q" = (
/turf/open/floor/iron,
/area/ruin/powered)
"R" = (
/obj/effect/decal/cleanable/dirt,
/obj/effect/turf_decal/stripes/line{
	dir = 4
	},
/turf/open/floor/iron,
/area/ruin/powered)
"T" = (
/obj/machinery/portable_atmospherics/canister/plasma,
/obj/effect/decal/cleanable/dirt,
/obj/effect/turf_decal/bot,
/turf/open/floor/iron,
/area/ruin/powered)
"U" = (
/obj/machinery/portable_atmospherics/canister/carbon_dioxide,
/obj/effect/turf_decal/bot,
/turf/open/floor/iron,
/area/ruin/powered)
"V" = (
/turf/closed/wall/r_wall,
/area/ruin/powered)

(1,1,1) = {"
V
V
V
V
V
V
V
V
V
"}
(2,1,1) = {"
V
k
I
N
U
z
z
e
V
"}
(3,1,1) = {"
i
k
t
v
U
z
z
p
V
"}
(4,1,1) = {"
V
a
O
O
O
O
O
O
V
"}
(5,1,1) = {"
V
Q
Q
Q
Q
Q
Q
Q
V
"}
(6,1,1) = {"
V
D
R
r
r
r
R
R
V
"}
(7,1,1) = {"
V
k
t
d
F
C
T
T
V
"}
(8,1,1) = {"
V
k
I
q
l
C
C
K
V
"}
(9,1,1) = {"
V
V
V
V
V
V
V
V
V
"}
