//MAP CONVERTED BY dmm2tgm.py THIS HEADER COMMENT PREVENTS RECONVERSION, DO NOT REMOVE
"b" = (
/obj/structure/rack,
/obj/item/storage/box/rxglasses{
	pixel_x = 3;
	pixel_y = 3
	},
/obj/item/storage/box/monkeycubes,
/obj/effect/spawner/random/ruinloot/medical,
/obj/effect/turf_decal/tile/blue/fourcorners/contrasted,
/turf/open/floor/iron/white,
/area/ruin/powered)
"c" = (
/obj/machinery/door/window/westright{
	dir = 1;
	name = "Monkey Pen";
	pixel_y = 2
	},
/turf/open/floor/iron/freezer,
/area/ruin/powered)
"d" = (
/obj/effect/turf_decal/tile/blue{
	dir = 4
	},
/turf/open/floor/iron/white,
/area/ruin/powered)
"e" = (
/obj/effect/turf_decal/tile/blue/half/contrasted{
	dir = 8
	},
/turf/open/floor/iron/white,
/area/ruin/powered)
"h" = (
/obj/structure/window/reinforced/spawner/directional/north{
	pixel_y = 1
	},
/turf/open/floor/iron/freezer,
/area/ruin/powered)
"j" = (
/obj/structure/table/glass,
/obj/item/storage/box/disks{
	pixel_y = 5
	},
/obj/item/clothing/gloves/color/latex,
/obj/item/clothing/gloves/color/latex,
/obj/effect/turf_decal/tile/blue/fourcorners/contrasted,
/turf/open/floor/iron/white,
/area/ruin/powered)
"k" = (
/obj/machinery/vending/wardrobe/gene_wardrobe,
/obj/effect/turf_decal/tile/blue/fourcorners/contrasted,
/turf/open/floor/iron/white,
/area/ruin/powered)
"m" = (
/obj/structure/sink/directional/west,
/obj/effect/turf_decal/tile/blue/half/contrasted,
/turf/open/floor/iron/white,
/area/ruin/powered)
"n" = (
/obj/structure/table/glass,
/obj/effect/spawner/random/ruinloot/medical,
/obj/effect/turf_decal/tile/blue/fourcorners/contrasted,
/turf/open/floor/iron/white,
/area/ruin/powered)
"o" = (
/obj/machinery/dna_scannernew,
/obj/effect/turf_decal/tile/blue/fourcorners/contrasted,
/turf/open/floor/iron/white,
/area/ruin/powered)
"q" = (
/turf/closed/wall,
/area/ruin/powered)
"r" = (
/obj/effect/turf_decal/tile/blue/anticorner/contrasted{
	dir = 1
	},
/turf/open/floor/iron/white,
/area/ruin/powered)
"s" = (
/obj/machinery/door/window/westleft{
	dir = 1;
	name = "Monkey Pen";
	pixel_y = 2
	},
/turf/open/floor/iron/freezer,
/area/ruin/powered)
"t" = (
/obj/effect/turf_decal/tile/blue{
	dir = 8
	},
/turf/open/floor/iron/white,
/area/ruin/powered)
"w" = (
/obj/effect/turf_decal/tile/blue{
	dir = 1
	},
/turf/open/floor/iron/white,
/area/ruin/powered)
"x" = (
/obj/structure/reagent_dispensers/fueltank,
/obj/item/weldingtool,
/turf/open/floor/plating,
/area/ruin/powered)
"y" = (
/obj/structure/chair/office/light{
	dir = 1
	},
/obj/effect/turf_decal/tile/blue/anticorner/contrasted{
	dir = 1
	},
/turf/open/floor/iron/white,
/area/ruin/powered)
"z" = (
/obj/structure/table/glass,
/obj/item/storage/pill_bottle/mutadone{
	pixel_x = -1;
	pixel_y = 4
	},
/obj/item/flashlight/pen{
	pixel_x = 1;
	pixel_y = 1
	},
/obj/effect/turf_decal/tile/blue/fourcorners/contrasted,
/turf/open/floor/iron/white,
/area/ruin/powered)
"A" = (
/obj/effect/turf_decal/tile/blue/half/contrasted,
/turf/open/floor/iron/white,
/area/ruin/powered)
"C" = (
/obj/structure/bed/roller,
/turf/open/floor/iron/freezer,
/area/ruin/powered)
"F" = (
/obj/effect/abstract/doorway_marker,
/turf/open/floor/plating,
/area/ruin/powered)
"G" = (
/obj/effect/turf_decal/tile/blue/half/contrasted{
	dir = 4
	},
/turf/open/floor/iron/white,
/area/ruin/powered)
"I" = (
/turf/open/floor/iron/white,
/area/ruin/powered)
"J" = (
/obj/structure/window/reinforced/spawner/directional/north{
	pixel_y = 1
	},
/obj/structure/bed/roller,
/turf/open/floor/iron/freezer,
/area/ruin/powered)
"K" = (
/turf/open/floor/iron/freezer,
/area/ruin/powered)
"L" = (
/obj/effect/abstract/doorway_marker{
	dir = 1
	},
/turf/open/floor/iron/white,
/area/ruin/powered)
"N" = (
/obj/effect/spawner/random/ruinloot/security,
/turf/open/floor/iron/freezer,
/area/ruin/powered)
"O" = (
/turf/open/floor/plating,
/area/ruin/powered)
"Q" = (
/obj/effect/abstract/doorway_marker{
	dir = 8
	},
/turf/open/floor/plating,
/area/ruin/powered)
"R" = (
/obj/machinery/vending/medical,
/obj/effect/turf_decal/tile/blue/fourcorners/contrasted,
/turf/open/floor/iron/white,
/area/ruin/powered)
"S" = (
/obj/machinery/computer/scan_consolenew{
	dir = 1
	},
/obj/effect/turf_decal/tile/blue/fourcorners/contrasted,
/turf/open/floor/iron/white,
/area/ruin/powered)
"U" = (
/obj/machinery/computer/scan_consolenew,
/obj/effect/turf_decal/tile/blue/fourcorners/contrasted,
/turf/open/floor/iron/white,
/area/ruin/powered)
"Y" = (
/obj/structure/chair/office/light,
/obj/effect/turf_decal/tile/blue/anticorner/contrasted{
	dir = 8
	},
/turf/open/floor/iron/white,
/area/ruin/powered)
"Z" = (
/obj/effect/turf_decal/tile/blue/half/contrasted{
	dir = 1
	},
/turf/open/floor/iron/white,
/area/ruin/powered)

(1,1,1) = {"
q
q
q
q
q
q
Q
q
q
"}
(2,1,1) = {"
q
n
z
j
n
q
O
O
q
"}
(3,1,1) = {"
q
U
y
Y
S
q
x
O
F
"}
(4,1,1) = {"
q
o
G
e
o
q
q
q
q
"}
(5,1,1) = {"
q
r
w
t
Z
Z
J
C
q
"}
(6,1,1) = {"
q
G
d
d
d
d
s
N
q
"}
(7,1,1) = {"
L
I
t
t
t
I
c
K
q
"}
(8,1,1) = {"
q
R
k
b
m
A
h
K
q
"}
(9,1,1) = {"
q
q
q
q
q
q
q
q
q
"}
